WWWWWWWWWWWWWWWW
WW............PW
WW......W......W
WW......W......W
W.......W.G....W
W.......W......W
W...W..........W
W...W...W...W..W
W...W..........W
W..............W
W.....W.......WW
W.....W........W
W..............W
W..............W
W..............W
WWWWWWWWWWWWWWWW