WWWWWWWWWWWWWWWW
W.......W..W...W
W...G...W......W
W.......W......W
WW......W.....WW
W..............W
W..............W
W.......P......W
W..............W
W..............W
W..............W
W..............W
W..............W
W.............WW
W.............WW
WWWWWWWWWWWWWWWW
