WWWWWWWWWWWWWWWW
W...........W..W
WW.............W
W..............W
W..............W
W..............W
W......G.......W
W..............W
W..............W
W..............W
W....WWWWWW....W
W....W......P..W
W..............W
W.............WW
W....W.........W
WWWWWWWWWWWWWWWW
