WWWWWWWWWWWWWWWW
W..............W
W..............W
W.........G..W.W
W...WW..WW..WW.W
W...WW..WW..WW.W
W..............W
W.....P........W
W...WW..WW.....W
W...WW..WW.....W
W...........WW.W
W...WW..WW..WW.W
W...WW.........W
W............WWW
W............WWW
WWWWWWWWWWWWWWWW