WWWWWWWWWWWWWWWW
W............W.W
W..............W
W..............W
W.W...G.WW.....W
W.W..WWWW......W
W.W........W...W
W..........WW..W
W..........WW..W
W....P.........W
W..........WW..W
W.WW...........W
W.WW...........W
W..W...........W
W.............WW
WWWWWWWWWWWWWWWW