WWWWWWWWWWWWWWWW
W..............W
W..............W
W..............W
W..............W
W..............W
W..G.WW.......WW
W....WW........W
W..............W
WWWW...........W
W..............W
W..............W
W.........W....W
W.........W....W
WP........W....W
WWWWWWWWWWWWWWWW
