WWWWWWWWWWWWWWWW
W..............W
W..............W
W..............W
W..............W
W..............W
W..............W
W..............W
W.......G......W
W..............W
W..............W
W..............W
W..............W
W..............W
WP.............W
WWWWWWWWWWWWWWWW
