WWWWWWWWWWWWWWWW
W..............W
W..............W
W............G.W
W.....WW.......W
W......W.......W
WW.............W
WW.............W
WW.............W
W.......WW.....W
W........W.....W
W.WWWW.........W
W...W..........W
W........W....WW
WP.......W.....W
WWWWWWWWWWWWWWWW