WWWWWWWWWWWWWWWW
W..............W
W..............W
WWW......WW.G..W
WWW.......W....W
W....W.........W
W....W.........W
W....W.........W
W...WW.........W
W..........WW..W
W..P........WW.W
W....WWWW......W
W..............W
W..............W
W..W..........WW
WWWWWWWWWWWWWWWW