WWWWWWWWWWWWWWWW
W..............W
W....G.........W
WW.............W
WW.....WWW....WW
W..............W
W..............W
W..............W
WWW............W
WW......W.....PW
W.......W......W
W..............W
W..............W
W.............WW
W...........WWWW
WWWWWWWWWWWWWWWW
